1111111111
1P000C0001
1000100001
11111100C1
1E00000001
1111111111
