1111111111
1E00000001
1111000C01
1000000001
1P00000C01
1111111111