1111111111111111111111
1P00000000000000000001
1000110000000000000001
1111110C00111000000001
1000000000000000CCC001
1000000000111111111111
1000000000000000000001
1E00000000000000000001
1111111111111111111111