1111111111111111111111
1P00000000000000000001
1000110000000000000001
1111110100111010000001
1000000C00000000110001
1000000C00111111111111
1000000C00000000000001
1E00000C00000000000001
1111111111111111111111