1111111111111111111111
1P000C0000000000000001
1000110000000000000001
1111110100111010000001
1000000100000000110001
1000000100111111111111
1000000000000000000001
1E000C0C00000000000001
1111111111111111111111