1111111111
1P00000001
1000100001
1111110001
1E00000001
1111111111