1111111111
1000000001
10001C0001
1111110001
1E00000001
1111111111