1111111111
1P00600K01
1000100001
1111110C01
1E00000000
1111111111