1111111111
1P00000001
10001000C1
1111110001
1100000001
1111111111
1000000001
1111111111