1111111111
1P00000001
1000100001
1111110C01
1E00000001
1111101111