1111111111
1P00000001
1110001001
1111110C01111
1E00000001
1111111111
